NO ./Textures/no_texture.xpm
SO ./Textures/so_texture.xpm
EA ./Textures/ea_texture.xpm
WE ./Textures/we_texture.xpm

F 20,212,68
C 0,137,255

        1111111111111111111111111
        1000000000110000000000001
        1011000001110000000000001
        1001000W00000000000000001
111111111011000001110000000000001
000000000011000001110111111111111
11110111111111011100000010001
11110111111111011101010010001
11000000110101011100000010001
1000000000000000110000001000111
100000000000000001101010010001
1100000111010101111101111000111
11110111 1110101 101111010001
11111111 1111111 111111111111
